NO ./asset/debug.png
SO ./asset/debug.png
WE ./asset/debug.png
EA ./asset/debug.png

F 0, 0, 0
C 0, 0, 200

11111111111
100N0000001
11111111111

