NO ./asset/debug.png
SO ./asset/debug.png
WE ./asset/debug.png
EA ./asset/debug.png

F 0, 0, 0
C 0, 0, 100


111111111111111111
100000000000000001
100000000000000001
100001111100000001
100001111100000001
100000111000000001
1000N0111000000001
100000111000000001
100000111000000001
100000111000000001
111111111111111111













