111111111111111111
100000000000000001
100000000000000001
100001111100000001
100001111100000001
100000111000000001
100000111000000001
100000111000000001
100000111000000001
100000111000000001
100000111000000001
100000111000000001
100000111000000001
100000111000000001
100000000000000001
100000000000000001
100000000000000001
100000000000000001
100000000000000001
100000000000000001
100000111000000001
100000111000000001
100000111000000001
111111111111111111