NO ./asset/debug_color.png
SO ./asset/stone.png
WE ./asset/debug.png
EA ./asset/brick.png

F 0, 255, 0
C 255, 255, 0


111111111111111111
100000000000000001
100000001000000001
10000000S000000001
111111111111111111
