F 255,255,255
C 255,0,0
EA ./asset/debug.png
WE ./asset/brick.png
NO ./asset/stone.png
SO ./asset/wood.png




111111111111111111
100000000000000001
100000000000000001
100001111100000001
1000E1111100000001
101000111000000001
101000111000000001
101000111000000001
101000111000000001
101000111000000001
101000111000000001
101000111000000001
101000111000000001
101000111000000001
101000111000000001
101000111000000001
101000111000000001
101000111000000001
101000111000000001
101000111000000001
101000111000000001
101000111000000001
101000111000000001
101000111000000001
101000111000000001
101000111000000001
101000111000000001
101000111000000001
101000111000000001
101000111000000001
101000111000000001
101000111000000001
101000111000000001
101000111000000001
101000111000000001
101000111000000001
101000111000000001
101000111000000001
101000111000000001
101000111000000001
101000111000000001
101000111000000001
101000111000000001
101000111000000001
101000111000000001
101000111000000001
101000111000000001
101000111000000001
101000111000000001
101000111000000001
101000111000000001
101000111000000001
101000111000000001
101000111000000001
101000111000000001
101000111000000001
101000111000000001
101000111000000001
101000111000000001
101000111000000001
101000111000000001
101000111000000001
101000111000000001
101000111000000001
101000111000000001
101000111000000001
101000111000000001
101000111000000001
101000111000000001
101000111000000001
101000111000000001
101000111000000001
101000111000000001
101000111000000001
101000111000000001
101000111000000001
101000111000000001
101000111000000001
101000111000000001
101000111000000001
101000111000000001
101000111000000001
101000111000000001
101000111000000001
101000111000000001
101000111000000001
101000111000000001
101000111000000001
101000111000000001
101000111000000001
101000111000000001
101000111000000001
101000111000000001
101000111000000001
101000111000000001
101000111000000001
101000111000000001
101000111000000001
101000111000000001
101000111000000001
101000111000000001
101000111000000001
101000111000000001
101000111000000001
101000111000000001
101000111000000001
101000111000000001
101000111000000001
101000111000000001
101000111000000001
101000111000000001
101000111000000001
101000111000000001
101000111000000001
101000111000000001
101000111000000001
101000111000000001
101000111000000001
101000111000000001
101000111000000001
101000111000000001
101000111000000001
101000111000000001
101000111000000001
101000111000000001
101000111000000001
101000111000000001
101000111000000001
101000111000000001
101000111000000001
101000111000000001
101000111000000001
101000111000000001
101000111000000001
101000111000000001
101000111000000001
101000111000000001
101000111000000001
101000111000000001
101000111000000001
101000111000000001
101000111000000001
101000111000000001
101000111000000001
101000111000000001
101000111000000001
101000111000000001
101000111000000001
101000111000000001
101000111000000001
101000111000000001
101000111000000001
101000111000000001
101000111000000001
101000111000000001
101000111000000001
101000111000000001
101000111000000001
101000111000000001
101000111000000001
101000111000000001
101000111000000001
101000111000000001
101000111000000001
101000111000000001
101000111000000001
101000111000000001
101000111000000001
101000111000000001
101000111000000001
101000111000000001
101000111000000001
101000111000000001
101000111000000001
101000111000000001
101000111000000001
101000111000000001
101000111000000001
101000111000000001
101000111000000001
101000111000000001
101000111000000001
101000111000000001
101000111000000001
101000111000000001
101000111000000001
101000111000000001
101000111000000001
101000111000000001
101000111000000001
101000111000000001
101000111000000001
101000111000000001
101000111000000001
101000111000000001
101000111000000001
101000111000000001
101000111000000001
101000111000000001
101000111000000001
101000111000000001
101000111000000001
101000111000000001
101000111000000001
101000111000000001
101000111000000001
101000111000000001
101000111000000001
101000111000000001
101000111000000001
101000111000000001
101000111000000001
101000111000000001
101000111000000001
101000111000000001
101000111000000001
101000111000000001
101000111000000001
101000111000000001
101000111000000001
101000111000000001
101000111000000001
101000111000000001
101000111000000001
101000111000000001
101000111000000001
101000111000000001
101000111000000001
101000111000000001
101000111000000001
101000111000000001
101000111000000001
101000111000000001
101000111000000001
101000111000000001
101000111000000001
101000111000000001
101000111000000001
101000111000000001
101000111000000001
101000111000000001
101000111000000001
101000111000000001
101000111000000001
101000111000000001
101000111000000001
101000111000000001
101000111000000001
101000111000000001
101000111000000001
101000111000000001
101000111000000001
101000111000000001
101000111000000001
101000111000000001
101000111000000001
101000111000000001
101000111000000001
101000111000000001
101000111000000001
101000111000000001
101000111000000001
101000111000000001
101000111000000001
101000111000000001
101000111000000001
101000111000000001
101000111000000001
101000111000000001
101000111000000001
101000111000000001
101000111000000001
101000111000000001
101000111000000001
101000111000000001
101000111000000001
101000111000000001
101000111000000001
101000111000000001
101000111000000001
101000111000000001
101000111000000001
101000111000000001
101000111000000001
101000111000000001
101000111000000001
101000111000000001
101000111000000001
101000111000000001
101000111000000001
101000111000000001
101000111000000001
101000111000000001
101000111000000001
101000111000000001
101000111000000001
101000111000000001
101000111000000001
101000111000000001
101000111000000001
101000111000000001
101000111000000001
101000111000000001
101000111000000001
101000111000000001
101000111000000001
101000111000000001
101000111000000001
101000111000000001
101000111000000001
101000111000000001
101000111000000001
101000111000000001
101000111000000001
101000111000000001
101000111000000001
101000111000000001
101000111000000001
101000111000000001
101000111000000001
101000111000000001
101000111000000001
101000111000000001
101000111000000001
101000111000000001
101000111000000001
101000111000000001
101000111000000001
101000111000000001
101000111000000001
101000111000000001
101000111000000001
101000111000000001
101000111000000001
101000111000000001
101000111000000001
101000111000000001
101000111000000001
101000111000000001
101000111000000001
101000111000000001
101000111000000001
101000111000000001
101000111000000001
101000111000000001
101000111000000001
101000111000000001
101000111000000001
101000111000000001
101000111000000001
101000111000000001
101000111000000001
101000111000000001
101000111000000001
101000111000000001
101000111000000001
101000111000000001
101000111000000001
101000111000000001
101000111000000001
101000111000000001
101000111000000001
101000111000000001
101000111000000001
101000111000000001
101000111000000001
101000111000000001
101000111000000001
101000111000000001
101000111000000001
101000111000000001
101000111000000001
101000111000000001
101000111000000001
101000111000000001
101000111000000001
101000111000000001
101000111000000001
101000111000000001
101000111000000001
101000111000000001
101000111000000001
101000111000000001
101000111000000001
101000111000000001
101000111000000001
101000111000000001
101000111000000001
101000111000000001
101000111000000001
101000111000000001
101000111000000001
101000111000000001
101000111000000001
101000111000000001
101000111000000001
101000111000000001
101000111000000001
101000111000000001
101000111000000001
101000111000000001
101000111000000001
101000111000000001
101000111000000001
101000111000000001
101000111000000001
101000111000000001
101000111000000001
101000111000000001
101000111000000001
101000111000000001
101000111000000001
101000111000000001
101000111000000001
101000111000000001
101000111000000001
101000111000000001
101000111000000001
101000111000000001
101000111000000001
101000111000000001
101000111000000001
101000111000000001
101000111000000001
101000111000000001
101000111000000001
101000111000000001
101000111000000001
101000111000000001
101000111000000001
101000111000000001
101000111000000001
101000111000000001
101000111000000001
101000111000000001
101000111000000001
101000111000000001
101000111000000001
101000111000000001
101000111000000001
101000111000000001
101000111000000001
101000111000000001
101000111000000001
101000111000000001
101000111000000001
101000111000000001
101000111000000001
101000111000000001
101000111000000001
101000111000000001
101000111000000001
101000111000000001
101000111000000001
101000111000000001
101000111000000001
101000111000000001
101000111000000001
101000111000000001
101000111000000001
101000111000000001
101000111000000001
101000111000000001
101000111000000001
101000111000000001
101000111000000001
101000111000000001
101000111000000001
101000111000000001
101000111000000001
101000111000000001
101000111000000001
101000111000000001
101000111000000001
101000111000000001
101000111000000001
101000111000000001
101000111000000001
101000111000000001
101000111000000001
101000111000000001
101000111000000001
101000111000000001
101000111000000001
101000111000000001
101000111000000001
101000111000000001
101000111000000001
101000111000000001
101000111000000001
101000111000000001
101000111000000001
101000111000000001
101000111000000001
101000111000000001
101000111000000001
101000111000000001
101000111000000001
101000111000000001
101000111000000001
101000111000000001
101000111000000001
101000111000000001
101000111000000001
101000111000000001
101000111000000001
101000111000000001
101000111000000001
101000111000000001
101000111000000001
101000111000000001
101000111000000001
101000111000000001
101000111000000001
101000111000000001
101000111000000001
101000111000000001
101000111000000001
101000111000000001
101000111000000001
101000111000000001
101000111000000001
101000111000000001
101000111000000001
101000111000000001
101000111000000001
101000111000000001
101000111000000001
101000111000000001
101000111000000001
101000111000000001
101000111000000001
101000111000000001
101000111000000001
101000111000000001
101000111000000001
101000111000000001
101000111000000001
101000111000000001
101000111000000001
101000111000000001
101000111000000001
101000111000000001
101000111000000001
101000111000000001
101000111000000001
101000111000000001
101000111000000001
101000111000000001
101000111000000001
101000111000000001
101000111000000001
101000111000000001
101000111000000001
101000111000000001
101000111000000001
101000111000000001
101000111000000001
101000111000000001
101000111000000001
101000111000000001
101000111000000001
101000111000000001
101000111000000001
101000111000000001
101000111000000001
101000111000000001
101000111000000001
101000111000000001
101000111000000001
101000111000000001
101000111000000001
101000111000000001
101000111000000001
101000111000000001
101000111000000001
101000111000000001
101000111000000001
101000111000000001
101000111000000001
101000111000000001
101000111000000001
101000111000000001
101000111000000001
101000111000000001
101000111000000001
101000111000000001
101000111000000001
101000111000000001
101000111000000001
101000111000000001
101000111000000001
101000111000000001
101000111000000001
101000111000000001
101000111000000001
101000111000000001
101000111000000001
101000111000000001
101000111000000001
101000111000000001
101000111000000001
101000111000000001
101000111000000001
101000111000000001
101000111000000001
101000111000000001
101000111000000001
101000111000000001
101000111000000001
101000111000000001
101000111000000001
101000111000000001
101000111000000001
101000111000000001
101000111000000001
101000111000000001
101000111000000001
101000111000000001
101000111000000001
101000111000000001
101000111000000001
101000111000000001
101000111000000001
101000111000000001
101000111000000001
101000111000000001
101000111000000001
101000111000000001
101000111000000001
101000111000000001
101000111000000001
101000111000000001
101000111000000001
101000111000000001
101000111000000001
101000111000000001
101000111000000001
101000111000000001
101000111000000001
101000111000000001
101000111000000001
101000111000000001
101000111000000001
101000111000000001
101000111000000001
101000111000000001
101000111000000001
101000111000000001
101000111000000001
101000111000000001
101000111000000001
101000111000000001
101000111000000001
101000111000000001
101000111000000001
101000111000000001
101000111000000001
101000111000000001
101000111000000001
101000111000000001
101000111000000001
101000111000000001
101000111000000001
101000111000000001
101000111000000001
101000111000000001
101000111000000001
101000111000000001
101000111000000001
101000111000000001
101000111000000001
101000111000000001
101000111000000001
101000111000000001
101000111000000001
101000111000000001
101000111000000001
101000111000000001
101000111000000001
101000111000000001
101000111000000001
101000111000000001
101000111000000001
101000111000000001
101000111000000001
101000111000000001
101000111000000001
101000111000000001
101000111000000001
101000111000000001
101000111000000001
101000111000000001
101000111000000001
101000111000000001
101000111000000001
101000111000000001
101000111000000001
101000111000000001
101000111000000001
101000111000000001
101000111000000001
101000111000000001
101000111000000001
101000111000000001
101000111000000001
101000111000000001
101000111000000001
101000111000000001
101000111000000001
101000111000000001
101000111000000001
101000111000000001
101000111000000001
101000111000000001
101000111000000001
101000111000000001
101000111000000001
101000111000000001
101000111000000001
101000111000000001
101000111000000001
101000111000000001
101000111000000001
101000111000000001
101000111000000001
101000111000000001
101000111000000001
101000111000000001
101000111000000001
101000111000000001
101000111000000001
101000111000000001
101000111000000001
101000111000000001
101000111000000001
101000111000000001
101000111000000001
101000111000000001
101000111000000001
101000111000000001
101000111000000001
101000111000000001
101000111000000001
101000111000000001
101000111000000001
101000111000000001
101000111000000001
101000111000000001
101000111000000001
101000111000000001
101000111000000001
101000111000000001
101000111000000001
101000111000000001
101000111000000001
101000111000000001
101000111000000001
101000111000000001
101000111000000001
101000111000000001
101000111000000001
101000111000000001
101000111000000001
101000111000000001
101000111000000001
101000111000000001
101000111000000001
101000111000000001
101000111000000001
101000111000000001
101000111000000001
101000111000000001
101000111000000001
101000111000000001
101000111000000001
101000111000000001
101000111000000001
101000111000000001
101000111000000001
101000111000000001
101000111000000001
101000111000000001
101000111000000001
101000111000000001
101000111000000001
101000111000000001
101000111000000001
101000111000000001
101000111000000001
101000111000000001
101000111000000001
101000111000000001
101000111000000001
101000111000000001
101000111000000001
101000111000000001
101000111000000001
101000111000000001
101000111000000001
101000111000000001
101000111000000001
101000111000000001
101000111000000001
101000111000000001
101000111000000001
101000111000000001
101000111000000001
101000111000000001
101000111000000001
101000111000000001
101000111000000001
101000111000000001
101000111000000001
101000111000000001
101000111000000001
101000111000000001
101000111000000001
101000111000000001
101000111000000001
101000111000000001
101000111000000001
101000111000000001
101000111000000001
101000111000000001
101000111000000001
101000111000000001
101000111000000001
101000111000000001
101000111000000001
101000111000000001
101000111000000001
101000111000000001
101000111000000001
101000111000000001
101000111000000001
101000111000000001
101000111000000001
101000111000000001
101000111000000001
101000111000000001
101000111000000001
101000111000000001
101000111000000001
101000111000000001
101000111000000001
101000111000000001
101000111000000001
101000111000000001
101000111000000001
101000111000000001
101000111000000001
101000111000000001
101000111000000001
101000111000000001
101000111000000001
101000111000000001
101000111000000001
101000111000000001
101000111000000001
101000111000000001
101000111000000001
101000111000000001
101000111000000001
101000111000000001
101000111000000001
101000111000000001
101000111000000001
101000111000000001
101000111000000001
101000111000000001
101000111000000001
101000111000000001
101000111000000001
101000111000000001
101000111000000001
101000111000000001
101000111000000001
101000111000000001
101000111000000001
101000111000000001
101000111000000001
101000111000000001
101000111000000001
101000111000000001
101000111000000001
101000111000000001
101000111000000001
101000111000000001
101000111000000001
101000111000000001
101000111000000001
101000111000000001
101000111000000001
101000111000000001
101000111000000001
101000111000000001
101000111000000001
101000111000000001
101000111000000001
101000111000000001
101000111000000001
101000111000000001
101000111000000001
101000111000000001
101000111000000001
101000111000000001
101000111000000001
101000111000000001
101000111000000001
101000111000000001
101000111000000001
101000111000000001
101000111000000001
101000111000000001
101000111000000001
101000111000000001
101000111000000001
101000111000000001
101000111000000001
101000111000000001
101000111000000001
101000111000000001
101000111000000001
101000111000000001
101000111000000001
101000111000000001
101000111000000001
101000111000000001
101000111000000001
101000111000000001
101000111000000001
101000111000000001
101000111000000001
101000111000000001
101000111000000001
101000111000000001
101000111000000001
101000111000000001
101000111000000001
101000111000000001
101000111000000001
101000111000000001
101000111000000001
101000111000000001
101000111000000001
101000111000000001
101000111000000001
101000111000000001
101000111000000001
101000111000000001
101000111000000001
101000111000000001
101000111000000001
101000111000000001
101000111000000001
101000111000000001
101000111000000001
101000111000000001
101000111000000001
101000111000000001
101000111000000001
101000111000000001
101000111000000001
101000111000000001
101000111000000001
101000111000000001
101000111000000001
101000111000000001
101000111000000001
101000111000000001
101000111000000001
101000111000000001
101000111000000001
101000111000000001
101000111000000001
101000111000000001
101000111000000001
101000111000000001
101000111000000001
101000111000000001
101000111000000001
101000111000000001
101000111000000001
101000111000000001
101000111000000001
101000111000000001
101000111000000001
101000111000000001
101000111000000001
101000111000000001
101000111000000001
101000111000000001
101000111000000001
101000111000000001
101000111000000001
101000111000000001
101000111000000001
101000111000000001
101000111000000001
101000111000000001
101000111000000001
101000111000000001
101000111000000001
101000111000000001
101000111000000001
101000111000000001
101000111000000001
101000111000000001
101000111000000001
101000111000000001
100000111000000001
100000111000000001
100000111000000001
100000111000000001
100000000000000001
100000000000000001
100000111000000001
100000111000000001
100000111000000001
100000111000000001
100000111000000001
100000111000000001
100000000000000001
100000000000000001
100000000000000001
100000000000000001
100000000000000001
100000000000000001
100000000000000001
100000000000000001
100000000000000001
100000000000000001
100000000000000001
100000000000000001
100000000000000001
100000000000000001
100000000000000001
100000000000000001
100000000000000001
100000000000000001
100000000000000001
100000000000000001
100000000000000001
100000000000000001
111111111111111111