NO ./asset/debug.png
SO ./asset/debug.png
WE ./asset/debug.png
EA ./asset/debug.png

F 0, 0, 0
C 0, 0, 100

 1111
1 W1
 1111