NO ./asset/debug.png
SO ./asset/debug.png
WE ./asset/debug.png
EA ./asset/debug.png

F 0, 0, 0
C 0, 0, 100

111111
10001
10N0111
10001
11111111
