NO ./asset/brick.png
SO ./asset/brick.png
WE ./asset/brick.png
EA ./asset/brick.png

F 0, 0, 0
C 0, 0, 100

111111
1000001
10N0D01
1000001
1111111
